####################_D####
############__________####
############__________####
############__############
############___###########
############_!_###########
############___###########
############__############
######______+++______#####
######_!____+!+____!_#####
######___###+++###___#####
############__############
##########____############
##########_!__############
##########____############
############__############
############__############
############_D############
